30x15
 WWWWWWWWWWWWWWWWWWWWWWWWWWWWWW
 WWPWPWPPPPPPPPPWPPPPPWPPPPPPPW
 WWPWPWWWPWPWWWPWPWWWPWPWWWWWPW
 WWPPPPPPPWPPPPPWPPPPPWPPPPPWPW
 WWWWWPWPWWWPWWWWWPWPWWWWWWPWPW
 WPPPPPWPPPWPPPPPWPWPPPWPPPPWPW
 WPWWWWWWWPWPWPSPWPWWWPWPWWWWPW
 WPPPPPPPWPWPWPPPWPWPPPWPPPWPPW
 WWWWWWWPWPWPWPWWWPWPWWWPWWWWPW
 WPPPPPWPPPWPWPPPWPWPWPPPWPPWPW
 WPWWWPWWWPWPWWWPWPWPWPWWWPWWPW
 WPPPPPPPWPWPPPWPPPWPWPWPPPPWPW
 WWWPWPWPWPWPWWWWWWWPWPWPWWWWPW
 WPPPWPWPPPWPPPPPPPWPPPWPPPPWPW
 WWPWWWWWWWWWWWWWWWWWWWWWWWWWPW