30x15
  ##############################
  ## # #         #     #       #
  ## # ### # ### # ### # ##### #
  ##   #   # #   #     #     # #
  ##### # ### ##### # ###### # #
  #     #   #     # #   #    # #
  # ####### # ##  # ### # #### #
  #       # # #   # #   #   #  #
  ####### # # # ### # ### #### #
  #     #   # #   # # #   #  # #
  # ### ### # ### # # # ### ## #
  #       # #   #   # # #    # #
  ### # # # # ####### # # #### #
  #   # #   #       #   #    # #
  ## ######################### #  